################
#.f.......c...c#
#...#.....c...c#
#####....##...##
#........#......
#.....c........#
#.c....#...#...#
#......#.c.....#
################