####SSS#########
#........#c.f.c#
#...b....#c...c#
#........####.##
................
#..............#
#.........b....#
#..............#
########.#######